28 36
EE EE EE EE EE EE EE EE EE EE EE EE EE EE EE EE EE EE EE EE EE EE EE EE EE EE EE EE
EE EE EE EE EE EE EE EE EE EE EE EE EE EE EE EE EE EE EE EE EE EE EE EE EE EE EE EE
EE EE EE EE EE EE EE EE EE EE EE EE EE EE EE EE EE EE EE EE EE EE EE EE EE EE EE EE
D1 DT DT DT DT DT DT DT DT DT DT DT DT D6 D5 DT DT DT DT DT DT DT DT DT DT DT DT D2
DL SD SD SD SD SD SD SD SD SD SD SD SD WR WL SD SD SD SD SD SD SD SD SD SD SD SD DR
DL SD C1 WB WB C2 SD C1 WB WB WB C2 SD WR WL SD C1 WB WB WB C2 SD C1 WB WB C2 SD DR
DL BD WR EE EE WL SD WR EE EE EE WL SD WR WL SD WR EE EE EE WL SD WR EE EE WL BD DR
DL SD C3 WT WT C4 SD C3 WT WT WT C4 SD C3 C4 SD C3 WT WT WT C4 SD C3 WT WT C4 SD DR
DL SD SD SD SD SD SD SD SD SD SD SD SD SD SD SD SD SD SD SD SD SD SD SD SD SD SD DR
DL SD C1 WB WB C2 SD C1 C2 SD C1 WB WB WB WB WB WB C2 SD C1 C2 SD C1 WB WB C2 SD DR
DL SD C3 WT WT C4 SD WR WL SD C3 WT WT C6 C5 WT WT C4 SD WR WL SD C3 WT WT C4 SD DR
DL SD SD SD SD SD SD WR WL SD SD SD SD WR WL SD SD SD SD WR WL SD SD SD SD SD SD DR
D3 DB DB DB DB C2 SD WR C7 WB WB C2 EE WR WL EE C1 WB WB C8 WL SD C1 DB DB DB DB D4
EE EE EE EE EE DL SD WR C5 WT WT C4 EE C3 C4 EE C3 WT WT C6 WL SD DR EE EE EE EE EE
EE EE EE EE EE DL SD WR WL EE EE EE NT EE EE NT EE EE EE WR WL SD DR EE EE EE EE EE
EE EE EE EE EE DL SD WR WL EE R1 DB R5 GD GD R6 DB R2 EE WR WL SD DR EE EE EE EE EE
DT DT DT DT DT C4 SD C3 C4 EE DR EE EE EE EE EE EE DL EE C3 C4 SD C3 DT DT DT DT DT
SL SL SL SL SL SL SD EE EE EE DR EE EE EE EE EE EE DL EE EE EE SD SL SL SL SL SL SL
DB DB DB DB DB C2 SD C1 C2 EE DR EE EE EE EE EE EE DL EE C1 C2 SD C1 DB DB DB DB DB
EE EE EE EE EE DL SD WR WL EE R3 DT DT DT DT DT DT R4 EE WR WL SD DR EE EE EE EE EE
EE EE EE EE EE DL SD WR WL EE EE EE EE EE EE EE EE EE EE WR WL SD DR EE EE EE EE EE
EE EE EE EE EE DL SD WR WL EE C1 WB WB WB WB WB WB C2 EE WR WL SD DR EE EE EE EE EE
D1 DT DT DT DT C4 SD C3 C4 EE C3 WT WT C6 C5 WT WT C4 EE C3 C4 SD C3 DT DT DT DT D2
DL SD SD SD SD SD SD SD SD SD SD SD SD WR WL SD SD SD SD SD SD SD SD SD SD SD SD DR
DL SD C1 WB WB C2 SD C1 WB WB WB C2 SD WR WL SD C1 WB WB WB C2 SD C1 WB WB C2 SD DR
DL SD C3 WT C6 WL SD C3 WT WT WT C4 SD C3 C4 SD C3 WT WT WT C4 SD WR C5 WT C4 SD DR
DL BD SD SD WR WL SD SD SD SD SD SD ND EE EE ND SD SD SD SD SD SD WR WL SD SD BD DR
D7 WB C2 SD WR WL SD C1 C2 SD C1 WB WB WB WB WB WB C2 SD C1 C2 SD WR WL SD C1 WB D8
D9 WT C4 SD C3 C4 SD WR WL SD C3 WT WT C6 C5 WT WT C4 SD WR WL SD C3 C4 SD C3 WT DA
DL SD SD SD SD SD SD WR WL SD SD SD SD WR WL SD SD SD SD WR WL SD SD SD SD SD SD DR
DL SD C1 WB WB WB WB C8 C7 WB WB C2 SD WR WL SD C1 WB WB C8 C7 WB WB WB WB C2 SD DR
DL SD C3 WT WT WT WT WT WT WT WT C4 SD C3 C4 SD C3 WT WT WT WT WT WT WT WT C4 SD DR
DL SD SD SD SD SD SD SD SD SD SD SD SD SD SD SD SD SD SD SD SD SD SD SD SD SD SD DR
D3 DB DB DB DB DB DB DB DB DB DB DB DB DB DB DB DB DB DB DB DB DB DB DB DB DB DB D4
EE EE EE EE EE EE EE EE EE EE EE EE EE EE EE EE EE EE EE EE EE EE EE EE EE EE EE EE
EE EE EE EE EE EE EE EE EE EE EE EE EE EE EE EE EE EE EE EE EE EE EE EE EE EE EE EE
